NO ./path_to_textures/north_wall.xpm
SO ./path_to_textures/south_wall.xpm
WE ./path_to_textures/west_wall.xpm
EA ./path_to_textures/east_wall.xpm

F 220,100,0
C 225,30,0

        1111111111111111111111111
        1000000000110000000000001
        1011000001110000000000001
        1001000000000000000000001
111111111011000001110000000000001
100000000011000001110111111111111
1111011111111101110000001
1111011111111101110101001
1100000011010101110000001
1000000000000000110000001
1000000000000000110101001
1100000111010101111101111
11110111 1110101 101110000001
1111011111111101110111111
111111111111111111111 